https://atmarkit.itmedia.co.jp/ait/articles/1607/20/news024.html
findコマンドの主な検索式
　findコマンドの主な検索式は次の通りです。

●ファイル名やファイルの種類
検索式	意味
-name パターン	ファイル名がパターンと一致するファイル（「-name "*.txt"」のような指定が可能）
-iname パターン	-nameと同じだが、大文字小文字を区別しない
-lname パターン	シンボリックリンクのリンク先ファイル名がパターンと一致するファイル
-ilname パターン	-lnameと同じだが、大文字小文字を区別しない
-path パターン	パスがパターンと一致するファイル
-ipath パターン	-pathと同じだが、大文字小文字を区別しない
-regex パターン	ファイル名がパターンと一致するファイル、パターンに正規表現が指定可能
-iregex パターン	-regexと同じだが、大文字小文字を区別しない
-type タイプ	ファイルタイプ（通常ファイルだけを対象としたい場合は「f」、ディレクトリは「d」、シンボリックリンクは「l」）
-xtype タイプ	-typeと同じだが、「-H」や「-P」が指定されている場合はリンク先のファイルタイプで判定する
-executable	実行可能なファイルまたは検索可能なディレクトリ（-permと違いACLなども考慮する）
-readable	読み込み可能なファイルにマッチする（-permと違いACLなども考慮する）
-writable	書き込み可能なファイルにマッチする（-permと違いACLなども考慮する）
-fstype タイプ	ファイルが置かれているファイルシステムのタイプ（ufs、nfs、tmpなど）

●タイムスタンプ関係
検索式	意味
-mmin 分数	指定した分数より前に更新されたファイル（「-mmin 3」で3分前、「-mmin +3」で3分以上前、「-mmin -3」で3分以内に更新、以下同）
-mtime 日数	指定した日数より前に更新されたファイル
-newer ファイル	指定したファイルの更新時刻以降に更新されたファイル
-amin 分数	指定した分数より前にアクセスされたファイル
-atime 日数	指定した日数より前にアクセスされたファイル
-anewer ファイル	指定したファイルのアクセス時刻以降にアクセスされたファイル
-cmin 分数	指定した分数より前にステータスが変更されたファイル
-ctime 日数	指定した日数より前にステータスが変更されたファイル
-cnewer ファイル	指定したファイルのステータス変更時刻にステータスが変更されたファイル
-daystart	-amin、-atime、-cmin、-ctime、-mmin、-mtimeで“今日”の始まりを今現在から24時間前ではなく、コマンド実行当日の0時にする

●その他の属性関係
検索式	意味
-uid 数値	所有者のユーザーIDが指定した数値のファイル
-user 名前	所有者の名前が指定した名前のファイル
-gid 数値	所有グループID番号が指定した数値のファイル
-group 名前	所有グループ名が指定した名前のファイル
-nouser	ユーザーIDに対応するユーザーがいないファイル
-nogroup	ユーザーグループID番号に対応するグループがないファイル
-perm モード	パーミッションがモードと一致したファイル（「-モード」で指定したモードを全て許可しているファイル、「/モード」で指定したモードのいずれかを許可しているファイル）
-empty	空のファイルまたは空のディレクトリ
-size サイズ	ファイルサイズが指定したサイズに一致したファイル（「-size +3k」でサイズが3KBより大きなファイル）
-links リンク数	リンク数が指定したリンク数に一致したファイル
-inum 番号	iノード番号が番号に一致したファイル
-samefile ファイル	指定したファイルと同じiノード番号を参照しているファイル（「-L」オプションが有効な場合はシンボリックリンクも含まれる）

●アクション他
検索式	意味
-print	見つけたファイルをフルパスで出力する（デフォルト）
-ls	見つけたファイルを「ls -dgils」形式で出力する
-print0	見つけたファイルのフルパスをNULL区切りで出力
-printf フォーマット	見つけたファイルをフォーマットに従った書式で出力する
-fprint ファイル	-printと同じ書式で指定したファイルに出力する
-fls ファイル	-lsと同じ書式で指定したファイルに出力する
-delete	見つけたファイルを消去する
-exec コマンド ;	見つけたファイルを引数にコマンドを実行する（オプションも指定可能。以下同）
-execdir コマンド ;	見つけたファイルのあるディレクトリでコマンドを実行する
-ok コマンド ;	見つけたファイルを引数に、確認メッセージを表示しながらコマンドを実行する（オプションも指定可能、以下同）
-okdir コマンド ;	見つけたファイルのあるディレクトリで、確認メッセージを表示しながらコマンドを実行する
-an、-a	条件をANDで結ぶ
-or、-o	条件をORで結ぶ
-not	条件を否定する
-true	常に真
-false	常に偽
-quit	直ちに終了する
-depth 深さ	検索するディレクトリの深さを指定
-maxdepth 深さ	検索するディレクトリの最大の深さ（「-maxdepth 0」でコマンドラインで指定したディレクトリのみ検索）
-mindepth 深さ	検索するディレクトリの最小の深さ（「-mindepth 1」でコマンドラインで指定したディレクトリより深いディレクトリを検索）
-prune	ディレクトリに降りない
-mount	他のファイルシステムにあるディレクトリを探索しない
-noleaf	「ディレクトリのハードリンク数から2を引いたものが、そのディレクトリに含まれるサブディレクトリの数である」という最適化を行わない
